..................................#................*
..................................#................*
..................................#................*
..................................#................*
..................................#................*
..................................#................*
........#.......#.................#................*
.....#   .............#...........#..%..........%..*
...........#.......#.........##...#.....%....%.....*
@..................................................*
###################################*****************