#.............................................................................................................#
#.............................................................................................................#
#.............................................................................................................#
#.............................................................................................................#
#.............................................................................................................#
#.............................................................................................................#
#.............................................................................................................#
#.............#........!...............................................................%.......%..............#
#...............................?............................#................................................#
#.....................(#.......................................................(%....................%........#
#.....#.........................#..................#..........................................................#
#.......................................................................%..................|................%..#
#......................................(#.....................................................................#
#.............................................................................................................#
#......@......................................................................................................#
#.............................................................................................................#
##############################################################################################################