#...............................................................................................................#
#...............................................................................................................#
#...............................................................................................................#
#...............................................................................................................#
#...............................................................................................................#
#........................................................................................!.....!................#
#...............................................................................................................#
#.............#........!...............................................................%.......%......!.........#
#...............................?............................#..................................................#
#.....................(#................................................!......(%.....................%......!..#
#......(#.......................#..................#............................................................#
#.......................................................................%..................|.................%..#
#......................................(#.......................................................................#
#...............................................................................................................#
#......@........................................................................................................#
#...............................................................................................................#
#   #   #   #   #   #   #   #   #   #   #   #   #   #   #   #   #   #   #   #   #   #   #   #   #   #   #   #   #