..............................................................#
..............................................................#
..............................................................#
..............................................................#
..............................................................#
..............................................................#
..............................................................#
...........#......!.....?.....................(%..............#
..............................................................#
.................(#.......................%.........%.........#
.....#..................#.....................................#
.......................................%......(.........%.....#
...............................(#.............................#
..............................................................#
..........@...................................................#
..............................................................#
###############################################################