......................................................................#
......................................................................#
......................................................................#
......................................................................#
......................................................................#
......................................................................#
......................................................................#
...........#......!..................................%................#
........................?.............................................#
.................(#..........................(%.............%.........#
.....#..................#.............................................#
.......................................%.............|.............%..#
...............................(#.....................................#
......................................................................#
......................................................................#
.....@................................................................#
#######################################################################