..................................#................*
..................................#................*
..................................#................*
..................................#................*
..................................#................*
..................................#................*
..................................#................*
............#.....................#................*
...................!..............#................*
..................#...............#................*
.....#..................#.........#................*
..................................#................*
..............................#...#................*
..................................#..%..........%..*
..................................#.....%....%.....*
@..................................................*
###################################*****************