..................................#................*
..................................#................*
..................................#................*
..................................#................*
..................................#................*
..................................#................*
........#.......#.................#................*
.....#................#...........#..%..........%..*
...........#.......#.........##...#.....%....%.....*
@..................................................*
###################################*****************