..............................................................#
..............................................................#
..............................................................#
..............................................................#
..............................................................#
..............................................................#
..............................................................#
...........#......!.............................%.............#
........................?.....................................#
.................(#.......................(%.........%........#
.....#..................#.....................................#
.......................................%........|.......%.....#
...............................(#.............................#
..............................................................#
....@.........................................................#
..............................................................#
###############################################################