..................................#................*
..................................#................*
..................................#................*
..................................#................*
..................................#................*
..................................#................*
..................................#................*
............#.....!.....?.........#................*
..................................#................*
.................(#...............#................*
.....#..................#.........#................*
..................................#................*
..............@...............#...#................*
..................................#..%..........%..*
..................................#.....%....%.....*
...................................................*
###################################*****************