#.............................................................................................................#
#.............................................................................................................#
#.............................................................................................................#
#.............................................................................................................#
#.............................................................................................................#
#........................................................................................!.....!..............#
#.............................................................................................................#
#.............#........!...............................................................%.......%.....!........#
#...............................?............................#................................................#
#.....................(#................................................!......(%....................%.....!..#
#......(#.......................#..................#..........................................................#
#.......................................................................%..................|...............%..#
#......................................(#.....................................................................#
#.............................................................................................................#
#......@......................................................................................................#
#.............................................................................................................#
#   #   #   #   #   #   #   #   #   #   #   #   #   #   #   #   #   #   #   #   #   #   #   #   #   #   #   # #