..............................................................#
..............................................................#
..............................................................#
..............................................................#
..............................................................#
..............................................................#
..............................................................#
...........#......!...........................(%..............#
........................?.....................................#
.................(#.......................%.........%.........#
.....#..................#.....................................#
.......................................%......(.........%.....#
...............................(#.............................#
..............................................................#
...@..........................................................#
..............................................................#
###############################################################