..................................#................*
..................................#................*
..................................#................*
..................................#................*
..................................#................*
..................................#................*
..................................#................*
............#.....!...............#................*
..................................#................*
.................(#...............#................*
.....#..................#.........#................*
..................................#................*
..............................#...#................*
..................................#..%..........%..*
..................................#.....%....%.....*
...................................................*
###################################*****************