..................................#................*
..................................#................*
..................................#................*
..................................#................*
..................................#................*
..................................#................*
..........#   ..#.................#................*
.....#   .............#...........#..%..........%..*
...........#.......#.........#  ..#.....%....%.....*
@..................................................*
###################################*****************