..................................#................*
..................................#................*
..................................#................*
..................................#................*
..................................#................*
..................................#................*
..................................#................*
............#.....!.....?.........#................*
..................................#................*
.................(#...............#................*
.....#..................#.........#................*
..................................#................*
..............................#...#................*
..................................#..%..........%..*
...@..............................#.....%....%.....*
...................................................*
###################################*****************